Also	ADV
sind	AUX
jetzt	ADV
alle	DET
NGOs	NOUN
auch	ADV
Parteien	NOUN
,	PUNCT
oder	CCONJ
alle	DET
Parteien	NOUN
auch	ADV
NGOs	NOUN
?	PUNCT
ğŸ¤”	SYM
ğŸ¤”	SYM

Euer	PRON
Ernst	NOUN
!?	PUNCT
ğŸ˜ƒ	SYM
ğŸ˜œ	SYM
ğŸ˜‚	SYM

Nice	X
bitte	ADV
nur	ADV
Ã„rzte	NOUN
^J^	SYM
fÃ¼r	ADP
Anbau	NOUN
ğŸ’˜	SYM
ğŸ¦„	SYM
ğŸ˜‡	SYM
ğŸ’¨	SYM
we	X
Love	X
legal	X
...	PUNCT

Das	PRON
ist	AUX
der	DET
Niedrigzinsphase	NOUN
Geschuldet	VERB
.	PUNCT
ğŸ™ˆ	SYM
ğŸ™Š	SYM
ğŸ™‰	SYM
ğŸ‘€	SYM

ğŸ³	SYM
ğŸŒˆ	SYM
ğŸ‘©	SYM
â¤	SYM
ğŸ‘©	SYM
ğŸ‘¨	SYM
â¤	SYM
ğŸ‘¨	SYM
ğŸ³	SYM
ğŸŒˆ	SYM
https://t.co/0C37OnNoCq	SYM

Malick	PROPN
fdp	PROPN
ğŸ˜¹	SYM
ğŸ˜¹	SYM
ğŸ˜­	SYM
ğŸ˜­	SYM
ğŸ˜­	SYM
ğŸ˜­	SYM
ğŸ˜¹	SYM
ğŸ˜¹	SYM
ğŸ˜¹	SYM
ğŸ˜¹	SYM

#CDU	NOUN
#SPD	NOUN
#GrÃ¼ne	NOUN
#Linke	NOUN
#FDP	NOUN

#maischberger	NOUN
#rtl	NOUN
#zdf	NOUN
#lanz	NOUN
#illner	NOUN
#merkel	NOUN
#sterntv	NOUN

Die	DET
@AfD_Bund	PROPN
will	AUX
das	DET
Grundgesetz	NOUN
Ã¤ndern	VERB
.	PUNCT

Jetzt	ADV
an	ADP
der	DET
#PHBern	PROPN
mit	ADP
@barbarajosef	PROPN
und	CCONJ
@wissensfabrik	PROPN
https://t.co/gIEWmq0Dxl	SYM
#Schule	NOUN
#Digitalisierung	NOUN

Liebe	ADJ
Frau	NOUN
@dunjahayali	PROPN

Auch	ADV
@MartinSchulz	PROPN
steht	VERB
fÃ¼r	ADP
Kungel	NOUN
mit	ADP
den	DET
Rechten	NOUN

SPD	PROPN
Schulz	PROPN
Ã¼ber	ADP
Rechtspopulisten	NOUN
"	PUNCT
Auf	ADP
groben	ADJ
Klotz	NOUN
gehÃ¶rt	VERB
grober	ADJ
Keil	NOUN
"	PUNCT
https://t.co/jWpXbXjODY	SYM
via	ADP
@SPIEGELONLINE	PROPN

